#...............................#
#...............................#
#...............................#
#......xxx......................#
#......"""......................#
#...........xxx.................#
#...........""".................#
#................x..x...........#
#................"""""".........#
#..........................x....#
#.....................x.."""....#
#...................""".........#
#b.p.....bb...x.x.x.............#
#"""""""""""""""""""""""""""""""#
