#....................................................#
#....................................................#
#....................................................#
#....................................................#
#....................#####...........................#
#.......................................##...........#
#.....#.....................###...##..........##.....#
#..##..#######..##...................................#
#..................................................###
#.............................###....................#
##....##.............................................#
#....................##....##......##....##....##....#
#....................................................#
#........##....##....................................#
#....................................................#
#..........##.....##.................................#
#.................................................#..#
#...........##........#...#...#..#...................#
#...#................................................#
#..................................#..#####...###....#
#.....#......................##......................#
#.....#.....#........................#...............#
##..........#........................................#
##..p....#####.....b....xx......b....................#
######################################################
